a=A
b=B
c=C
d=D
e=E
f=F
g=G
h=H
i=I
j=J
k=K
l=L
m=M
n=N
o=O
p=P
q=Q
r=R
s=S
t=T
u=U
v=V
w=W
x=X
y=Y
z=Z
†=µ
É=∂
«=∆
Ñ=é
•=§
Ü=è
á=Ä
ü=¨
‘=“
–=—
Ç=ê
©=®
â=”
ÿ=∑
°=÷
å=◊
í=ë
à=ù
ñ=ï
‰=„
Â=’
¢=‡
ì=‚
ã=ä
î=ô
Í=Ë
˝=¸
ò=ó
Á=Ê
≠=∏
Ó=›
ú=õ
Ö=ﬁ
£=È
˚=Î
Å=ö
Ï=Ì
´=ç
ß=¶
æ=Ω