a=A
b=B
c=C
d=D
e=E
f=F
g=G
h=H
i=I
j=J
k=K
l=L
m=M
n=N
o=O
p=P
q=Q
r=R
s=S
t=T
u=U
v=V
w=W
x=X
y=Y
z=Z
†=Ä
°=Å
¢=Ç
£=É
§=Ñ
•=Ö
Ò=
¶=Ü
ß=á
®=à
©=â
™=ä
´=ã
¨=å
≠=ç
Æ=é
Ø=è
‡=ê
·=ë
‚=í
„=ì
‰=î
Â=ï
Ê=ñ
Á=ó
Ë=ò
È=ô
Ï=ú
Î=õ
Í=ö
Ì=ù
Ó=û
Ô=ü
ı=Ù
˜=ˆ